###########
#E        #
# ### ### #
#         #
### # # ###
#   # #   #
# ### ### #
#        S#
###########
